11111111111111111111111
1P000000000000000000001
10111111100111111111001
10100000100100000001001
10101110100100111001001
10100000100100111001101
10111111100100000000101
10000000000111111111101
10000000110000000000001
10000000110000000000001
1001110CCC0000000000001
100101000000G0000111001
10011110C01111111101001
10011010C01010101011001
10011110C01111111111001
10000000000000000000001
100000000000000000000E1
11111111111111111111111