10100000000000000000000000000100010000000000000000000000000000101
10100000000000000000000000000100010000000000000000000000000000101
10100000000000000000000000000100010000000000000000000000000000101
10100000000000000000000000000100010000000000000000000000000000101
10111111111111111111111111111100011111111111111111111111111111101
10000000000000000000000000000000000000000000000000000000000000001
11111111111111111111111111111111111111111111111111111111111111111