11111111111111111111111111111111111111111111111111111
10000000000000000000000000000000000C00000000000000001
1000CCCCCCCCC000C00C000C0000C000000C00000000000000001
1000000000000CC0000C000000000000000000000000000000001
10000000CC000000C0C0001111111111000000000000000000001
10000000C0CCC00CCC00001000000001000000000000000000001
10000000000000000000001000000001000000000000000000001
1000000C000000000000001000000001000000000000000000001
10000000000000000000001000000001000000000000E00000001
10000000000C000000C0001000000001000000000000000000001
10000000000000000000001000000001000000000000000000001
100000000000C000C000001000000001000000000000000000001
10000000000000000000001000000001000000000000000000001
1000000C00C00000000000C1110C0C11000000000000000000001
1000000000000000000000000000000000C0C0C0C000000000001
1000000000000C000000000000000000000000000C00000000001
100000000000000C0000000000000000000000000000000000001
1000000000000000C000000000000000000000000000000000001
100000C0C0C00000000000000000000000000000000C000000001
10000000000000000000000000000000000000P00000000000001
100000C0000000000000000000000000000000000000000000001
100000000000000000C0000000000000000000000000000000001
100000000000C0000000000000000000000000000000000000001
10000000000000000000000000000000000000000000000000001
10000C00000C00000C000C0000000000000000000000000000001
10000000000000000000000000000000000000000000000000001
10000000000000000000000000000000000000000000000000001
11111111111111111111111111111111111111111111111111111