11111111111111111111111111111111111111111111111111111111111111111
10000000000000000000000000000000000000000000000000000000000000001
10111111110001111111110001111111111111110001111111111111111111101
10100000010001000000010001000000000000010001000000000000000000101
10100000010001000000010001000000000000010001000000000000000000101
10100000010001000000010001000000000000010001000000000000000000101
10100000010001000000010001000000000000010001000000000000000000101
10111111110001111111110001111111111111110001111111111111111111101
1C00000000000000000000000000000P000000000000000000000000G00000001
10111111111111111111111111111100011111111111111111111111111111101
1010000000000000000000000000010E010000000000000000000000000000101
10100000000000000000000000000100010000000000000000000000000000101
10100000000000000000000000000100010000000000000000000000000000101
10100000000000000000000000000100010000000000000000000000000000101
10100000000000000000000000000100010000000000000000000000000000101
10100000000000000000000000000100010000000000000000000000000000101
10100000000000000000000000000100010000000000000000000000000000101
10100000000000000000000000000100010000000000000000000000000000101
10111111111111111111111111111100011111111111111111111111111111101
1000000000000000000000000000000C000000000000000000000000000000001
11111111111111111111111111111111111111111111111111111111111111111