1111111111111111111111111111111
1000010000100000000100001000001
1000010000100000000100001000001
1000010000100000000100001000001
1000000000000000000000000000001
1000010000100000000100001000001
1000010000100000000100001000001
1000010000100000000100001000001
1000010000100000000100001000001
1000010000111101111100001000001
1000010001000000000010001000001
1000010010000000000001001000001
1000010100000000000000101000001
1000001000000000000000010000001
1000000111111101111111100000001
1000100000000000000000000100001
1001000000000000000000000010001
1010000000000000000000000001001
1100000000000000000000000000101
1000000000000000000000000000011
1111111111111111111111111111111
